10 10 50 1
0 0 0 0 0 0 0 0 0 0
0 0 0 0 Z 0 0 0 0 0
0 0 0 0 0 W 0 0 0 0
0 W 0 0 0 0 0 0 W 0
0 0 0 0 0 0 0 0 0 0
0 0 W 0 0 0 0 0 0 0
0 0 0 0 W 0 0 0 0 0
0 0 0 0 0 0 W 0 0 0
0 0 0 0 0 0 0 0 S 0
0 0 0 0 0 0 0 0 0 0