10 10 40
W W W W W W W W W W
W Z W W G W W W 0 W
W 0 0 0 0 0 0 0 0 W
W W W W W W W W 0 W
W S 0 0 0 W 0 0 0 W
W W W W 0 W G W 0 W
W 0 0 0 0 W 0 W 0 W
W 0 W W 0 W 0 W 0 W
W 0 G 0 0 0 0 0 0 W
W W W W W W W W W W