20 20 200 1
W W 0 0 0 W 0 0 W W 0 0 0 0 0 0 W W W W
0 S W W W W 0 W W W 0 W W W W W W 0 0 0
W 0 W 0 W W 0 0 0 W 0 0 W 0 W W W 0 W W
W 0 W 0 W W W W 0 W 0 0 0 0 0 0 0 0 W W
W 0 W 0 W 0 0 0 0 W 0 0 0 0 0 0 W W W 0
W 0 0 0 0 0 W W W W W W 0 W 0 0 0 0 0 0
W W W 0 W 0 0 0 0 W 0 W 0 W W 0 W W W 0
0 0 W 0 W W 0 W W W 0 W 0 W 0 0 0 0 W 0
W 0 W 0 0 W 0 0 0 W 0 0 0 W 0 W W W W W
W 0 W W 0 W 0 W W W 0 W W W 0 0 0 0 0 0
W 0 0 0 0 0 0 0 w w w w w W 0 W 0 W W W
0 0 0 W 0 W 0 W w w w w w W 0 W 0 W 0 0
0 W W W 0 W 0 W 0 W W 0 0 W W W 0 W 0 0
0 W 0 0 0 W 0 W 0 W 0 0 0 0 W 0 0 W 0 0
0 W 0 W W W W W 0 W W W 0 W W W 0 W 0 0
0 W 0 W 0 0 0 0 0 0 0 W 0 0 W 0 0 W 0 0
0 0 0 W 0 W W W W W W W 0 0 0 0 0 W 0 0
W W W W 0 W 0 0 0 W W W W W W W W W W W
W Z w W 0 W 0 W 0 W 0 0 0 0 G 0 0 0 0 0
W W w W 0 W 0 W W W 0 0 0 0 0 0 0 0 0 0 
