10 10
0 0 0 0 0 0 Z 0 0 0
0 0 0 0 0 0 0 0 0 0
0 0 0 0 0 0 0 0 0 0
0 0 0 0 0 0 0 0 0 0
0 0 0 0 0 0 0 0 0 0
0 0 0 0 0 0 0 0 0 0
0 0 0 0 0 0 0 0 0 0
0 W W W W W W W W W
0 0 0 0 0 S 0 0 0 0
0 0 0 0 0 0 0 0 0 0