10 10 50 0
W 0 W W 0 W W W 0 W
W 0 W W 0 0 W W 0 W
0 0 0 0 0 0 0 0 0 0
W W W 0 G 0 W W W W
0 0 0 G G G W W Z 0
W W W 0 G 0 W W W W
0 0 0 0 0 0 0 0 0 0
W W 0 W 0 0 W W 0 W
W 0 0 W 0 W W W S W
W 0 W W 0 W W W 0 W