20 20 300 0
W W W W W W W W W W W W W W W W W W W W 
W 0 0 0 0 0 0 0 0 0 0 0 0 0 0 0 0 0 Z W
W 0 0 0 0 0 0 0 0 0 0 0 0 0 0 0 0 0 0 W
W 0 0 0 0 0 0 0 0 0 0 0 0 0 0 0 0 0 0 W
W 0 0 0 0 0 0 0 0 0 0 0 0 0 0 0 0 0 0 W
W 0 0 G G G G 0 0 0 0 0 0 0 0 0 0 0 0 W
W 0 0 G G G G 0 0 0 0 0 0 0 0 0 0 0 0 W
W 0 0 G G G G 0 0 0 0 0 0 0 0 0 0 0 0 W
W 0 0 G G G G 0 0 0 0 0 0 0 0 0 0 0 0 W
W 0 0 G G G G 0 0 0 0 0 0 0 0 0 0 0 0 W
W 0 0 G G G G 0 0 0 0 0 0 0 0 0 0 0 0 W
W 0 0 G G G G 0 0 0 0 0 0 0 0 0 0 0 0 W
W W W W W W W W W W W W W W W W W W 0 W
W 0 0 G W 0 0 0 0 0 0 0 0 0 0 0 0 0 0 W
W 0 W H W 0 0 0 P 0 0 0 W W W W W W b W
W 0 W 0 W 0 0 0 0 0 0 0 W W H H H H H W
W 0 W 0 W 0 P 0 0 0 P 0 b b H H H H H W
W 0 W 0 W 0 W W W W W W W H H H H A H W
W S W 0 0 0 W 0 0 0 0 0 0 H H A H H H W
W W W W W W W W W W W W W W W W W W W W 