20 20 100 0
W W 0 0 0 W 0 0 0 0 0 0 0 0 0 0 W W W W
0 S W W W W 0 0 0 0 0 0 0 0 0 W W 0 0 0
W 0 W 0 0 0 0 0 0 0 0 0 0 0 0 W W 0 W W
W 0 0 0 0 0 0 0 0 0 0 0 0 0 0 0 0 0 W W
W 0 0 0 0 0 0 0 0 0 0 0 0 0 0 0 W W W 0
W 0 0 0 0 0 0 0 0 0 0 0 0 0 0 0 0 0 0 0
W 0 0 0 0 0 0 0 0 0 0 0 0 0 0 0 W W 0 0
0 0 0 0 0 0 0 0 0 0 0 0 0 0 0 0 0 W W 0
0 0 0 0 0 0 0 0 0 0 0 0 0 0 0 0 0 0 0 0
0 0 0 0 0 0 0 0 0 0 0 0 0 0 0 0 0 0 0 0
0 0 0 0 0 0 0 0 0 0 0 0 0 0 0 0 0 0 0 0
0 0 0 0 0 0 0 0 0 0 0 0 0 0 0 0 0 0 0 0
0 0 0 0 0 0 0 0 0 0 0 0 0 0 0 0 0 0 0 0
0 0 0 0 0 0 0 0 0 0 0 0 0 0 0 0 0 0 0 0
0 0 0 W W W W 0 0 0 0 0 0 0 0 0 0 0 0 0
0 0 0 W 0 0 0 0 0 0 0 0 0 0 0 0 0 0 0 0
0 W 0 W 0 W W W 0 0 0 0 0 0 0 0 0 0 0 0
W W W W 0 W 0 0 0 0 0 0 0 0 0 0 0 0 0 0
W Z 0 W 0 W 0 W 0 0 0 0 0 0 0 0 0 0 0 0
W W 0 W 0 W 0 W 0 0 0 0 0 0 0 0 0 0 0 0 
