10 10 40 0
W W W W 0 W W W W W
0 0 0 W 0 0 0 0 0 0
W W 0 W W W Z W W W
W W 0 W W W W W W W
0 0 0 W 0 0 0 0 0 0
W W 0 W W W 0 W W W
W W 0 W W W 0 W W W
W W g 0 0 W 0 W W W
0 S W W 0 W 0 0 0 0
W W W W 0 W W W W W