10 10 50 1
W 0 W W W 0 0 0 0 0
W G W G W 0 W W W W
0 G W 0 0 0 W 0 0 0
W W W W S 0 b 0 W W
0 0 0 0 0 G W 0 0 0
W W W W 0 0 W W W W
0 0 0 0 0 0 0 0 0 0
W W 0 W W W W W W W
W 0 0 W G G W G W Z
W 0 W W W 0 W 0 W 0