10 10 50 1
W 0 W W W 0 0 0 0 W
W G W G W 0 W W W W
0 G W 0 0 0 W 0 G 0
W W W W 0 0 W 0 W W
0 0 0 0 0 G W 0 G 0
W W W W G 0 W W W W
0 0 0 0 0 0 0 0 0 0
W W 0 W W W W W W W
W 0 0 W G G W W Z W
W 0 W W W 0 W W 0 W