10 10 40 0
W W W W 0 W W W W W
0 0 0 W Z 0 0 0 0 0
W W 0 W W W W W W W
W W 0 W W W S W W W
0 0 0 W 0 0 0 0 0 0
W W 0 W W W 0 W W W
W W 0 W 0 W 0 W W W
W W 0 0 0 W 0 W W W
0 0 W W 0 W 0 0 0 0
W W W W 0 W W W W W1