20 20 300 0
W W W W W W W W W W W W W W W W W W W W 
W 0 0 0 0 0 0 0 0 0 0 0 0 0 0 0 0 0 Z W
W 0 0 0 0 0 0 0 0 0 0 0 0 0 0 0 0 0 0 W
W 0 0 0 0 0 0 0 0 0 0 0 0 0 0 0 0 0 0 W
W 0 0 0 0 0 0 0 0 0 0 0 0 0 0 0 0 0 0 W
W 0 0 G G G G 0 0 0 0 0 0 0 0 0 0 0 0 W
W 0 0 G G G G 0 0 0 0 0 0 0 0 0 0 0 0 W
W 0 0 G G G G 0 0 0 0 0 0 0 0 0 0 0 0 W
W 0 0 G G G G 0 0 0 0 0 0 0 0 0 0 0 0 W
W 0 0 G G G G 0 0 0 0 0 0 0 0 0 0 0 0 W
W 0 0 G G g G 0 0 0 0 0 0 0 0 0 0 0 0 W
W 0 0 G G G G 0 0 0 0 0 0 0 0 0 0 0 0 W
W W W W W W W W W W W W W W W W W W 0 W
W 0 0 G W 0 0 0 0 0 0 0 0 0 0 0 0 0 0 W
W 0 W H W 0 0 0 P 0 0 0 W W W W W W b W
W 0 W 0 W 0 0 0 0 0 0 0 W W 0 0 H H H W
W 0 W 0 W 0 P 0 0 0 P 0 b b 0 0 H H H W
W 0 W 0 W 0 W W W W W W W 0 0 0 H A H W
W S W 0 0 0 W 0 0 0 0 0 0 0 0 A H H H W
W W W W W W W W W W W W W W W W W W W W 