10 10 20 1
0 0 0 0 0 0 0 W 0 0
0 0 W W 0 0 0 Z 0 W
0 G 0 0 0 0 W 0 0 0
0 0 0 0 0 G 0 0 0 0
0 0 0 0 0 0 W 0 0 0
G 0 0 0 S 0 0 0 0 0
0 0 0 0 0 0 0 0 0 0
0 0 0 0 0 0 0 0 G 0
0 W 0 0 W 0 W W 0 0
0 0 0 G 0 0 0 0 0 0 0