10 10 16 0
W W W W 0 0 0 W W W
W Z W 0 0 W W W 0 W
W 0 W 0 W W 0 W 0 W
W 0 0 0 0 0 0 0 0 W
W 0 W 0 W 0 W W W W
W 0 W 0 W 0 0 0 0 W
W 0 W 0 W W W 0 W W
W 0 W 0 0 0 W 0 W W
W 0 W W W S W 0 W W
W W W W W W W W W W